20000000000000000003
20000000000000000003
20000000000000000003
20000000000000000003
20000000000450000003
20000000000000000003
20000000000000000003
20000000000000000003
20000000000450000003
20000000000000000003
20000000000000000003
20000000000000000003
20000000000411111113
20000004500000000003
20000000000000000003
20041500000000000003
20000000000000000003
20000000450000000003
20000000000000000003
20000000000411111113
20000000000000000003
20000000000000000003
21150000000000000003
20000000000411111113
20000000000000000003
20000000000000000003
20000000000411111113
20000000000000000003
20000000000000000003
20000000000000000003
20000000000411111113
20000000000000000003
20000000000000000003
20000000000000000003
20000000000000000003
20000000000411111113
20000000000000000003
20000000000000000003
20000000000000000003
20000000000000000003
20000000000411111113
20000000000000000003
21111150000000000003
20000000000000000003
20000000000000000003
20000000000004111113
20000000000000000003
20000000000000000003
20000000000000000003
20000000000000000003
20000000000411111113
20000000000000000003
20041150000000000003
20000000000000000003
20000000000000000003
20000000000411111113
20000000000000000003
20000000000000000003
21111115000000000003
20000000000000000003
20000000000000000003
20000000000000000003
20000000000000000003
26666666666666666663